6	35	35	35	35	35	35	35	35	35	35	35	35	35	35	35	35	35	35	35	35	35	35	35	35	35	35	35	35	35	35	35	35	35	35	35	35	35	35	35	35	35	35	35	35	35	35	35	35	35	35	35	35	35	35	35	35	35	35	35	35	35	35	35	35	35	35	35	35	35	35	35	35	35	35	35	35	35	35	35	35	35	35	35	35	35	35	35	35	35	35	35	35	35	35	35	35	35	35	35	35	35	35	35	35	35	35	35	35	35	35	35	35	35	35	35	35	35	35	35	35	35	35	35	35	35	35	35	35	35	35	35	35	35	35	35	35	35	35	35	35	35	35	35	7	18	18	19
19	102	103	103	103	103	103	103	103	103	103	103	103	103	103	103	103	103	103	103	103	103	103	103	103	103	103	103	103	103	103	103	103	103	103	103	103	103	103	103	103	103	103	103	103	103	103	103	103	103	103	103	103	103	103	103	103	103	103	103	103	103	103	103	103	103	103	103	103	103	103	103	103	103	103	103	103	103	103	103	103	103	103	103	103	103	103	103	103	103	103	103	103	103	103	103	103	103	103	103	103	103	103	103	103	103	103	103	103	103	103	103	103	103	103	103	103	103	103	103	103	103	103	103	103	103	103	103	103	103	103	103	103	103	103	103	103	103	103	103	103	103	103	121	17	18	18	19
19	119	120	120	120	120	120	120	120	120	120	120	120	120	120	120	120	120	120	120	120	120	120	120	120	120	120	120	120	120	120	120	120	120	120	120	120	120	120	120	120	120	120	120	120	120	120	120	120	120	120	120	120	120	120	120	120	120	120	120	120	120	120	120	120	120	120	120	120	120	120	120	120	120	120	120	120	120	120	120	120	120	120	120	120	120	120	120	120	120	120	120	120	120	120	120	120	120	120	120	120	120	120	120	120	120	120	120	120	120	120	120	120	120	120	120	120	120	120	120	120	120	120	120	120	120	120	120	120	120	120	120	120	120	120	120	120	120	120	120	120	120	120	121	17	18	18	19
19	119	120	120	120	120	120	120	120	120	120	120	120	120	120	120	120	120	120	120	120	120	120	120	120	120	120	120	120	120	120	120	120	120	120	120	120	120	120	120	120	120	120	120	120	120	120	120	120	120	120	120	120	120	120	120	120	120	120	120	120	120	120	120	120	120	120	120	120	120	120	120	120	120	120	120	120	120	120	120	120	120	120	120	120	120	120	120	120	120	120	120	120	120	120	120	120	120	120	120	120	120	120	120	120	120	120	120	120	120	120	120	120	120	120	120	120	120	120	120	120	120	120	120	120	120	120	120	120	120	120	120	120	120	120	120	120	120	120	120	120	120	120	121	17	18	18	19
19	119	120	120	120	120	120	120	120	120	120	120	120	120	120	120	120	120	120	120	120	120	120	120	120	120	120	120	120	120	120	120	120	120	120	120	120	120	120	120	120	120	120	120	120	120	120	120	120	120	120	120	120	72	120	120	120	120	120	120	120	120	120	120	120	120	120	120	120	120	120	120	120	120	120	120	120	120	120	120	120	120	120	120	120	120	120	120	120	120	120	120	120	120	120	120	120	120	120	120	120	120	120	120	120	120	120	120	120	120	120	120	120	120	120	120	120	120	120	120	120	120	120	120	120	120	120	120	120	120	120	120	120	120	120	120	120	120	120	120	120	120	120	121	17	18	18	19
19	119	120	120	120	120	120	120	120	120	120	120	120	120	120	120	120	120	120	120	120	120	120	120	120	120	120	120	120	120	120	120	120	120	120	120	120	120	120	120	120	120	120	120	120	120	120	120	120	120	120	120	120	120	120	120	120	120	68	70	120	68	69	69	70	120	120	72	120	120	120	120	120	120	120	120	120	120	120	120	120	120	120	120	120	120	120	120	120	120	120	120	120	120	120	120	120	120	120	120	120	120	120	120	120	120	120	120	120	120	120	120	120	120	120	120	120	120	120	120	120	120	120	120	120	120	120	120	120	120	120	120	120	120	72	120	120	120	120	120	120	120	120	121	17	18	18	19
19	119	120	120	120	120	120	120	120	120	120	120	120	120	120	120	120	120	120	120	120	120	120	120	120	120	120	120	120	120	120	120	120	120	120	120	120	120	120	120	120	120	120	120	120	120	120	120	72	120	120	120	120	120	120	120	120	120	120	120	120	120	120	120	120	120	120	120	120	120	120	120	120	120	120	120	120	120	120	120	120	120	120	120	120	120	120	120	120	120	120	120	120	120	120	120	120	120	120	120	120	120	120	120	120	120	120	120	108	137	137	109	120	108	137	137	109	120	120	120	120	120	120	120	120	120	120	120	120	120	120	120	120	120	120	120	120	120	120	120	120	120	120	121	17	18	18	19
19	119	120	120	120	120	120	120	120	120	120	120	120	120	120	120	120	120	120	120	120	120	120	120	120	120	120	120	120	120	120	120	120	120	120	120	120	120	120	120	120	120	120	120	120	120	120	120	120	120	108	137	109	120	120	120	120	120	120	120	120	120	120	120	120	120	120	120	120	120	120	120	120	120	120	120	120	120	120	120	120	120	120	120	120	120	120	120	120	120	120	120	120	120	120	120	120	120	120	120	120	120	120	120	120	120	120	120	121	0	2	119	108	138	0	2	119	120	120	120	120	120	120	120	120	120	120	120	120	120	120	4	120	120	120	120	120	120	120	120	120	120	120	121	17	18	18	19
19	119	120	120	120	120	120	120	120	120	120	120	120	120	108	137	137	137	137	137	137	137	137	137	137	109	120	120	120	120	120	120	120	120	120	120	120	120	120	120	120	120	120	120	120	108	137	137	137	137	138	4	136	137	137	137	109	120	120	120	120	120	120	120	120	120	120	120	120	108	137	137	137	137	137	137	109	120	120	120	120	120	120	120	120	120	120	120	120	120	120	120	120	120	120	120	120	120	120	120	120	120	120	120	120	120	120	120	121	17	19	119	121	68	74	19	119	120	120	120	120	120	120	120	120	120	120	120	120	120	120	21	120	120	120	120	120	120	120	120	120	120	120	121	17	18	18	19
19	119	120	120	120	120	120	120	120	120	120	120	120	120	121	0	1	1	1	1	1	1	1	1	2	119	120	120	120	120	120	120	120	120	120	120	120	120	120	120	120	120	120	120	120	121	0	1	1	1	1	75	1	1	1	2	119	120	120	120	120	120	120	120	120	120	120	120	120	121	0	1	1	1	1	2	119	120	120	120	120	120	120	120	120	120	120	120	120	120	120	120	120	120	120	120	120	120	120	120	120	120	120	120	120	120	72	120	121	17	19	136	163	104	17	19	119	120	120	4	120	120	120	120	120	120	120	4	120	120	120	26	1	1	1	1	1	1	2	120	120	120	120	121	17	18	18	19
36	119	120	120	120	120	120	120	68	70	120	120	120	120	121	17	18	18	18	18	18	18	18	18	19	119	120	120	120	120	120	120	120	120	120	120	120	120	120	120	120	120	120	120	120	121	17	18	18	18	18	18	18	18	18	19	119	120	120	120	120	120	120	120	120	120	120	120	120	121	17	18	18	18	18	19	119	120	120	68	70	120	120	72	120	120	120	120	120	120	120	120	120	120	120	120	120	120	120	120	120	120	120	120	120	120	120	120	121	17	57	70	119	121	17	19	119	120	120	21	120	120	120	120	120	120	120	21	120	120	120	34	35	35	35	35	35	35	36	120	120	120	120	121	34	35	35	36
120	120	120	120	120	120	120	120	120	120	120	120	120	120	121	17	18	18	18	18	18	18	18	18	19	119	120	120	120	68	70	120	120	120	120	68	70	120	120	120	120	68	70	120	120	121	17	18	18	18	18	18	18	18	18	19	119	120	120	4	120	120	120	4	120	120	120	4	120	121	17	18	18	18	18	19	119	120	120	120	120	120	120	120	120	120	68	70	120	120	72	120	120	120	120	120	120	120	120	120	120	120	72	120	120	120	120	120	121	34	36	102	180	138	17	19	119	120	120	21	120	120	120	4	120	120	120	38	120	120	120	120	120	120	120	120	120	120	120	120	120	120	120	125	103	103	103	103
120	120	120	120	120	120	120	120	120	120	120	120	68	70	121	17	18	18	18	18	18	18	18	18	19	119	120	120	120	120	120	120	120	120	120	120	120	120	120	120	120	120	120	120	120	121	17	18	18	18	18	18	18	18	18	19	119	120	120	21	120	120	120	21	120	120	120	21	120	121	17	18	18	18	18	19	119	120	120	120	120	120	120	120	120	120	120	120	120	120	120	120	120	68	70	120	120	72	120	120	120	120	120	120	120	120	120	120	125	103	103	126	121	68	74	19	119	120	120	21	120	120	120	21	120	120	120	120	120	120	120	120	120	108	137	137	137	137	137	109	120	108	137	137	137	137	137	137
137	137	137	137	137	137	137	137	137	137	137	137	137	137	138	17	18	18	18	18	18	18	18	18	19	119	120	120	120	120	120	120	120	120	120	120	120	120	120	120	120	120	120	120	120	121	17	18	18	18	18	18	18	18	18	19	119	120	120	21	120	120	120	21	120	120	120	21	120	121	17	18	18	18	18	19	119	120	120	120	120	120	120	120	120	120	120	120	120	120	120	120	120	120	120	120	120	120	120	108	137	137	137	137	137	137	137	137	137	137	137	137	185	172	17	19	119	120	120	21	120	120	120	21	120	120	120	120	120	120	120	4	120	121	0	1	1	1	2	119	120	121	0	1	1	1	1	2
0	1	1	1	1	1	1	1	1	1	1	1	1	1	1	24	18	18	18	18	18	18	18	18	19	119	120	120	120	120	120	120	120	120	120	120	120	120	120	120	120	120	120	120	120	121	17	18	18	18	18	18	18	18	18	19	119	120	120	21	120	120	120	21	120	120	120	21	120	121	17	18	18	18	18	19	119	120	120	120	120	120	120	120	120	120	120	120	120	120	120	120	120	120	120	120	120	120	120	121	0	1	1	1	1	1	1	1	1	1	1	1	1	1	24	19	119	120	120	21	120	120	120	21	120	120	120	4	120	120	120	21	120	121	17	18	18	18	19	119	120	121	17	18	18	18	18	19
17	18	18	18	18	18	18	18	18	18	18	18	18	18	18	18	18	18	18	18	18	18	18	18	19	119	120	120	120	120	120	120	120	120	120	120	120	120	120	120	120	120	120	120	120	121	17	18	18	18	18	18	18	18	18	19	119	120	120	21	120	120	120	21	120	120	120	21	120	121	17	18	18	18	18	19	119	120	120	120	120	120	120	120	120	120	120	120	120	120	120	120	120	120	120	120	120	120	120	121	17	18	18	18	18	18	18	18	18	18	18	18	18	18	18	19	119	120	120	21	120	120	120	21	120	120	120	21	120	120	120	21	120	121	17	18	18	18	19	119	120	121	17	18	18	18	18	19
