18	18	18	18	18	18	18	18	18	18	18	18	18	18	18	18	18	18	18	18	18
35	7	6	35	35	35	7	18	18	18	6	35	35	35	7	18	18	18	6	35	35
103	34	10	103	103	103	17	18	18	6	36	103	103	103	17	18	18	35	36	103	103
120	120	26	2	120	120	34	35	35	36	120	120	120	120	34	58	36	120	120	120	120
120	120	17	19	120	120	120	120	120	120	120	120	120	120	120	38	120	120	120	120	120
120	120	34	36	120	120	120	120	120	120	120	120	120	120	120	120	120	120	120	120	120
120	120	120	120	120	120	120	120	120	120	120	120	120	120	120	120	120	120	120	120	120
120	120	120	120	120	120	120	120	120	120	120	120	120	120	120	120	120	68	69	70	120
120	120	120	120	120	120	120	120	120	120	120	120	120	120	120	120	120	120	120	120	120
120	120	120	120	120	120	120	120	120	120	120	68	69	69	70	120	120	120	120	120	120
120	120	120	120	120	120	120	120	120	120	120	120	120	120	120	120	120	120	120	120	120
120	120	120	120	120	68	69	70	120	120	120	120	120	120	120	120	120	120	120	4	120
120	120	120	120	120	120	120	120	120	120	120	120	120	120	120	120	0	1	1	27	120
120	120	4	120	120	120	120	120	120	120	120	120	120	120	120	0	24	18	18	19	120
120	0	75	2	120	120	120	120	0	1	1	1	2	120	68	74	18	18	18	19	120
120	17	18	23	2	120	120	120	17	18	18	18	19	120	120	17	18	18	18	19	120
