18	18	18	18	18	18	18	18	18	18	18	18	18	18	18	18	18	18	18	18	18
35	35	35	35	35	35	35	35	35	35	35	35	35	35	7	18	6	35	35	35	35
103	103	103	103	103	103	103	103	103	103	103	103	103	103	17	6	36	103	103	103	103
120	120	120	120	120	120	120	120	120	120	120	120	120	120	17	36	120	120	120	120	120
120	120	120	120	120	120	120	120	120	120	120	120	120	120	21	120	120	120	120	120	120
120	120	120	120	120	120	120	120	120	120	120	120	68	69	33	120	120	120	120	120	120
120	120	120	120	120	120	120	120	120	120	120	120	120	120	120	120	120	120	120	120	120
120	4	120	120	120	120	120	120	120	120	120	120	120	120	120	120	120	120	120	120	120
120	32	67	1	66	70	120	120	120	120	120	120	120	120	120	120	15	69	69	70	120
120	120	34	35	36	120	120	120	120	120	120	120	120	120	120	68	33	120	120	120	120
120	120	120	120	120	120	120	120	120	120	108	137	137	109	120	120	120	120	120	120	120
120	120	120	120	120	120	120	120	120	108	138	0	2	111	137	137	137	109	120	120	120
120	108	137	137	137	109	120	120	108	138	0	24	19	123	68	67	2	119	120	120	120
120	121	0	1	2	136	137	137	138	0	24	18	19	128	104	17	19	136	137	137	109
120	121	34	35	61	1	1	1	1	24	18	18	19	119	121	34	61	1	1	2	119
120	125	103	104	17	18	18	18	18	18	18	18	19	119	125	104	17	18	18	19	119
