18	18	18	18	18	18	18	18	18	18	18	18	18	18	18	18	18	18	18	18	18
35	35	35	35	7	18	18	18	18	6	35	35	35	35	35	35	35	35	7	6	35
103	103	103	103	17	18	18	18	18	19	103	103	103	103	103	103	103	103	17	19	103
120	120	120	0	24	18	18	18	18	19	120	120	120	120	120	120	120	120	17	19	120
120	120	120	17	18	6	35	35	35	83	16	120	120	120	120	120	120	0	24	19	120
120	120	15	84	35	36	120	120	120	120	26	2	120	120	120	120	120	17	6	36	120
120	15	33	120	120	120	120	120	120	68	84	61	2	120	120	120	0	78	36	120	120
120	38	120	120	120	120	120	120	120	120	120	34	36	120	120	120	34	36	120	120	120
120	120	120	120	120	120	120	120	120	120	120	120	120	120	120	120	120	120	120	120	120
120	120	120	120	120	120	120	120	120	120	120	120	120	120	120	120	120	120	120	120	120
120	120	120	120	120	120	120	120	120	120	120	120	120	120	120	120	120	120	120	120	120
120	120	120	120	120	108	137	137	137	109	120	120	120	120	120	120	120	108	137	137	109
120	120	120	120	108	138	0	1	2	119	120	120	120	120	120	120	108	138	0	2	119
108	137	137	137	138	0	24	18	19	136	137	137	137	137	137	137	138	0	24	19	119
121	68	69	69	67	24	18	18	23	1	1	1	1	1	1	1	1	24	18	19	119
125	103	103	104	17	18	18	18	18	18	18	18	18	18	18	18	18	18	18	19	119
