18	18	18	18	18	18	18	18	18	18	18	18	18	18	18	18	18	18	18	18	18
35	35	35	35	35	35	35	35	35	35	35	35	35	35	35	35	35	35	35	35	35
103	103	103	103	103	103	103	103	103	103	103	103	103	103	103	103	103	103	103	103	103
120	120	120	120	120	120	120	120	120	120	120	120	120	120	120	120	120	120	120	120	120
120	120	120	120	120	120	120	120	120	120	120	120	120	120	120	120	120	120	120	120	120
120	120	120	120	120	120	120	120	120	120	120	120	120	120	120	120	120	120	120	120	120
120	120	120	120	120	120	120	120	120	120	120	120	120	120	120	120	120	120	120	120	120
120	120	120	120	120	120	120	120	120	120	120	120	120	120	120	120	120	120	120	120	120
120	120	120	120	120	120	120	120	120	120	120	120	120	120	120	120	120	120	120	120	120
120	120	120	120	120	120	120	120	120	120	4	120	120	120	120	120	120	120	120	120	120
120	120	120	120	120	120	120	4	120	120	21	120	120	4	120	120	120	120	120	120	120
120	120	120	4	120	120	120	21	120	120	21	120	120	21	120	120	120	4	120	120	120
120	120	120	21	120	120	120	21	120	120	21	120	120	21	120	120	120	21	120	120	120
120	4	120	21	120	120	120	21	120	120	21	120	120	21	120	120	120	21	120	4	120
120	21	120	21	120	120	120	21	120	120	21	120	120	21	120	120	120	21	120	21	120
120	21	120	21	120	120	120	21	120	120	21	120	120	21	120	120	120	21	120	21	120
