18	18	18	18	18	18	18	18	18	18	18	18	18	18	18	18	18	18	18	18	18
35	35	35	35	35	35	35	35	35	35	35	35	35	35	35	35	35	35	35	35	35
103	103	103	103	103	103	103	103	103	103	103	103	103	103	103	103	103	103	103	103	103
120	120	120	120	120	120	120	120	120	120	120	120	120	120	120	120	120	120	120	120	120
120	120	120	120	120	120	120	120	120	120	120	120	120	120	120	120	120	120	120	120	120
120	120	120	120	120	120	120	120	120	120	120	120	120	120	120	120	120	120	120	120	120
120	120	120	120	120	120	120	120	120	120	120	120	120	68	69	69	69	69	69	69	70
120	120	120	120	120	120	120	120	120	120	72	120	120	120	120	120	120	120	120	120	120
120	120	120	120	120	120	120	120	120	120	120	120	120	120	120	120	120	120	120	120	120
120	120	120	120	120	120	72	120	120	120	120	120	120	120	120	120	120	120	120	120	120
120	120	120	120	120	120	120	120	120	120	120	120	120	68	69	69	69	69	69	69	16
120	120	72	120	120	120	120	120	120	120	120	120	120	120	120	120	120	120	120	120	21
120	120	120	120	120	120	120	120	120	120	68	70	120	120	120	120	120	120	120	120	21
108	137	137	137	4	137	137	137	137	137	137	137	137	137	137	137	137	137	109	120	21
121	0	1	1	75	1	1	1	1	1	1	1	1	1	1	1	1	2	119	120	21
121	17	18	18	18	18	18	18	18	18	18	18	18	18	18	18	18	19	119	120	21
