18	18	18	18	18	18	18	18	18	18	18	18	18	18	18	18	18	18	18	18	18
35	35	35	35	35	35	35	35	35	35	35	35	35	35	35	35	35	35	35	35	35
103	103	103	103	103	103	103	103	103	103	103	103	103	103	103	103	103	103	103	103	103
120	120	120	120	120	120	120	120	120	120	120	120	120	120	120	120	120	120	120	120	120
120	120	120	120	120	120	120	120	120	120	120	120	120	120	120	120	120	120	120	120	120
120	120	120	120	120	120	120	120	120	120	120	120	120	120	120	120	120	120	120	120	120
120	120	120	120	120	120	120	120	120	120	120	120	120	120	120	120	120	120	120	120	120
120	4	120	120	4	120	120	120	120	120	120	120	120	120	120	120	120	120	120	120	120
120	32	69	67	64	70	120	120	120	120	120	120	120	120	120	120	120	120	120	120	120
120	120	120	34	36	120	120	120	120	120	120	120	72	120	120	120	120	120	120	120	120
120	120	120	120	120	120	120	120	120	120	120	120	120	120	120	120	120	120	120	120	120
120	120	120	120	120	120	0	2	120	120	120	120	120	120	120	120	120	120	120	120	120
120	120	120	120	120	0	24	19	120	120	120	120	120	120	120	120	120	120	120	120	120
120	120	120	120	0	24	18	19	120	120	120	120	120	120	0	1	2	120	120	120	120
120	120	0	1	24	18	18	23	2	120	120	120	120	0	24	18	23	2	120	120	120
120	0	24	18	18	18	18	18	23	1	2	120	120	17	18	18	18	23	1	1	2
