18	18	18	18	18	18	18	18	18	18	18	18	18	18	18	18	18	18	18	18	18
35	35	35	35	35	35	35	35	35	35	35	35	35	35	35	35	35	35	35	35	35
103	103	103	103	103	103	103	103	103	103	103	103	103	103	103	103	103	103	103	103	103
120	120	120	120	120	120	120	120	120	120	120	120	120	120	120	120	120	120	120	120	120
120	120	120	120	120	120	120	120	120	120	120	120	120	120	120	120	120	120	120	120	120
120	120	120	120	120	120	120	120	120	120	120	120	120	120	120	120	120	120	120	120	120
120	120	120	120	120	120	120	120	120	120	120	120	120	120	120	120	120	120	120	120	120
120	120	120	120	120	120	120	120	120	120	120	120	68	69	69	69	69	70	120	120	120
120	120	120	120	120	120	120	120	120	120	72	120	120	120	120	120	120	120	120	120	120
120	120	120	120	120	120	120	120	120	120	120	120	120	120	120	120	120	120	120	120	120
120	120	120	120	120	120	120	68	70	120	120	120	120	120	72	120	120	120	72	120	120
120	120	120	120	120	120	120	120	120	120	120	120	120	120	120	120	120	120	120	120	120
120	120	120	68	70	120	120	120	120	120	108	137	109	120	120	120	120	120	120	120	120
108	137	137	137	137	137	137	137	137	137	138	4	119	120	72	120	120	120	72	120	120
121	68	67	1	1	1	1	1	1	1	66	33	119	120	120	120	120	120	120	120	120
125	104	17	18	18	18	18	18	18	18	19	102	126	120	120	120	120	120	120	120	120
